0..........
X33333.....
X33333.....
X33333.....
X33333#####
X33333....G
........#..
........#..
......###..
......#....
......#....