............
.0..........
.X..........
.X..........
.X33333.....
.X33333.....
.X..........
.X.......###
.X.......#.#
.X.......#.#
.X......##G#
.X.........#